BSH = "countries/Basrah.txt"
UAE = "countries/United Arab Emirates.txt"
CAR = "countries/Carthage.txt"
HEJ	= "countries/Hejaz.txt"
KER = "countries/Karbala.txt"
KUR = "countries/Kurds.txt"
TRM = "countries/Turkmeneli.txt"
ASS = "countries/Assyria.txt"
HAT = "countries/Hatay.txt"
BOR = "countries/Bordeaux Republic.txt"
SCO = "countries/Scotland.txt"
WAL = "countries/Wales.txt"
MOR = "countries/Moravia.txt"
BAL = "countries/Baltics.txt"
MED = "countries/Mediterranean Federation.txt"
WIF = "countries/West Indies.txt"
MLT = "countries/Malta.txt"
SIC = "countries/Sicily.txt"
NAP = "countries/Naples.txt"
ANH = "countries/Anhui.txt"
SHA = "countries/Shangdong.txt"
SVN = "countries/Slovenia.txt"
BOS = "countries/Bosnia.txt"
MAC = "countries/Macedonia.txt"
ALE = "countries/Aleppo.txt"
DAM = "countries/Damascus.txt"
ALA = "countries/Alawites.txt"
DRU = "countries/Druze.txt"
SZC = "countries/Sichuan.txt"
KAR = "countries/Karelia.txt"
TRA = "countries/Transcaucasia.txt"
RUS = "countries/Russia.txt"
TKM = "countries/Turkmenistan.txt"
UZB = "countries/Uzbekistan.txt"
TAJ = "countries/Tajikistan.txt"
KYR = "countries/Kyrgistan.txt"
TLE = "countries/Tlemcen.txt"
ALG = "countries/Algeria.txt"
MAU = "countries/Mauritania.txt"
NIG = "countries/Nigeria.txt"
NGR = "countries/Niger.txt"
GUI = "countries/Guinea.txt"
CAF = "countries/Central Africa.txt"
MLI = "countries/Malinke.txt"
BUR = "countries/Burma.txt"
SPK = "countries/Spanish Kingdom.txt"
SPA = "countries/Spanish State.txt"
QUI = "countries/Quing.txt"
BAN = "countries/Banda.txt"
BAY = "countries/Baya.txt"
KAN = "countries/Kanem Borno.txt"
SOK = "countries/Sokoto.txt"
YOU = "countries/Yourba.txt"
IGB = "countries/Igboland.txt"
IVO = "countries/Ivory Coast.txt"
SON = "countries/Soninke.txt"
MOS = "countries/Mossi.txt"
CEY = "countries/Ceylon.txt"
BEN = "countries/Bengal.txt"
ASA = "countries/Assam.txt"
KKP = "countries/Karakalpakstan.txt"
JAV = "countries/Java.txt"
SUM = "countries/Sumatra.txt"
HYD = "countries/Hyderabad.txt"
SSA = "countries/Socialist America.txt"
SIN = "countries/Singapore.txt"
MRC = "countries/Morocco.txt"
NID = "countries/NorthernIreland.txt"
LUB = "countries/Luba.txt"
TRI = "countries/Tripolitania.txt"